8 3 5 2 1 7 9 4 6
4 6 1 8 9 3 5 7 2
7 9 2 4 5 6 8 1 3
9 2 4 6 3 1 7 5 8
1 5 6 7 8 9 2 3 4
3 7 8 5 2 4 1 6 9
2 8 3 1 6 5 4 9 7
5 4 9 3 7 2 6 8 1
6 1 7 9 4 8 3 2 5 