6 8 1 7 9 2 5 4 3
3 2 7 8 4 5 1 6 9
4 9 5 1 6 3 2 7 8
7 4 8 6 5 9 3 1 2
1 5 2 3 7 4 8 9 6
9 3 6 2 8 1 7 5 4
2 6 3 9 1 7 4 8 5
5 1 9 4 2 8 6 3 7
8 7 4 5 3 6 9 2 1