2 6 8 5 7 9 3 4 1
4 5 7 2 1 3 8 6 9
7 2 5 6 8 1 9 3 4
1 8 4 3 9 2 6 7 5
6 9 3 7 4 5 1 2 8
8 3 6 9 5 4 2 1 7
5 7 1 8 2 6 4 9 3
9 4 2 1 3 7 5 8 6