8 1 5 3 4 6 9 2 7
7 9 2 5 1 8 6 3 4
3 6 4 7 9 2 5 8 1
4 2 1 8 5 3 7 9 6
9 5 7 2 6 4 3 1 8
6 3 8 9 7 1 2 4 5
1 4 9 6 2 5 8 7 3
5 7 3 1 8 9 4 6 2
2 8 6 4 3 7 1 5 9