7 1 4 6 3 9 8 5 2
5 6 2 1 7 8 3 9 4
9 3 8 4 2 5 1 6 7
4 7 1 2 6 3 5 8 9
8 9 3 7 5 4 2 1 6
2 5 6 8 9 1 7 4 3
3 4 5 9 8 7 6 2 1
6 8 9 3 1 2 4 7 5
1 2 7 5 4 6 9 3 8